116b31D13d1111111D111111111111d1111
555311D1711141111D11553111111331111
541111D1111111111D111161111B1A11111
437741D11A1111111D111111T11E1115571
173611ICCHCCCCCCCF1CCCCCCCC1111111A
111111111Dsc1111111111111111P111111
1s1111111D11111111l1111b41111111111
161111111D1111111111111111b11111111
1s1111JCCLCCCCCCG111111T11114351111
1111s3D115811111A111111111111161111
b11111D111111111D1111111A1111111111
c11111D111111111ICC11A1CE1111111111
11s111D1111111P111111111D1CCCCC1111
111111D111111111111l1111D1111111111
111111D11l11111111111111D11111b1111
11111dD11111111114811111D1111111111
CCCCCCE11111111111111111D1111111111
111111ICCCCCCCCs11111111D1111111111
111111111111111111111111D1111111111
11b1111l111115551111T11111114431111
111111111111113111l1111111116111111
1111b111T111111111111d1111111111111
1l111111144117311111111111113711111
1153111115311111111d1111111116d1111
1114111111111111c111111111111111111
