116b31D13d1111111D111111111111
555311D1711111111D111111111111
541111D1111111111D111111111111
437741D11A1111111D111111111111
173611ICCHCCCCCCCF111111111111
111111111Dsc111111111111111111
1s1111111D11111111111111111111
161111111D11111111111111111111
1s1111JCCLCCCCCCG1111111111111
1111s3D115811111A1111111111111
b11111D111111111D1111111111111
c11111D111111111ICC11111111111
11s111D1111111P111111111111111
111111D11111111111111111111111
111111D11l11111111111111111111
11111dD11111111111111111111111
CCCCCCE11111111111111111111111
111111ICCCCCCCCs11111111111111
111111111111111111111111111111
111111111111111111111111111111
